abbreviation	nutrient_type
EX_ca2_e	micro
EX_cbl1_e	micro
EX_cl_e	micro
EX_co2_e	substrate
EX_cobalt2_e	micro
EX_cu2_e	micro
EX_fe2_e	micro
EX_fe3_e	micro
EX_glc__D_e	macro
EX_h2o_e	substrate
EX_h_e	substrate
EX_k_e	micro
EX_mg2_e	micro
EX_mn2_e	micro
EX_mobd_e	micro
EX_na1_e	micro
EX_nh4_e	macro
EX_ni2_e	micro
EX_o2_e	macro
EX_pi_e	macro
EX_sel_e	micro
EX_slnt_e	micro
EX_so4_e	macro
EX_tungs_e	micro
EX_zn2_e	micro
